S......#..
......#.##
.#.....##.
#.#.......
........#.
#.....##..
..###.###.
#......##.
#...##...#
#..#..#.#G
